#############################################################
#.#...#.....#.......#.........#.#.......#.....#.....#.......#
#.#.#.#.###.#####.#.#####.###.#.#.#.###.#.###.#.#####.#####.#
#...#...#.........#.....#...#.#...#.#...#.#...#.......#.....#
#######################.###.#.#####.#.###.#.#######.###.#####
#.....#...............#.#...#...#...#.#...#.#.....#...#.....#
###.#.#.###.###.#######.#.#####.###.#.#.###.###.#.#####.###.#
#...#.#...#.#...#.......#.S.#.......#...#.#.....#.....#...#.#
#.###.###.#.#####.#########.###########.#.###########.#####.#
#...#...#.#.#...#.#.........#.......#...#...........#...#...#
#.#.###.###.#.#.#.#####.#####.#####.#######.#######.###.#.#.#
#.#...#.....#.#...#...#.....#.....#.#.......#...#.#.....#.#.#
#.#.#.#####.#.#####.#.###.#######.#.#.#####.#.#.#.#######.###
#.#.#.#.#...#...#.#.#...#...#.....#.#.....#...#.....#.......#
#.###.#.#.#####.#.#.###.###.#.#####.#.#############.#######.#
#.#...#...#...#.....#...#.#.#.#...#.#.#...#.......#...#.....#
#.#.#######.#.#######.###.#.#.###.#.###.#.#.#####.###.#.#.###
#.#.........#.....#.#.#.....#...#.#.#...#...#...#.#.#.#.#...#
#################.#.#.###.#####.#.#.#.#######.###.#.#.#####.#
#...#...#.......#...#.#.......#...#.#.........#...#...#.....#
#.#.#.#.#.#####.#.###.#.#########.#.###.#######.###.###.###.#
#.#...#...#...#.#.#...#...#.....#.#.#...#...#...#.#.#...#...#
#.###########.#.#.#.#####.#.###.#.#.#.###.#.#.###.#.###.#.###
#.......#...#.....#.#.....#...#...#.......#.#.#.#...#...#.#.#
#.#####.###.#.###.#.###.#.###.###############.#.#.###.###.#.#
#.#...#...#.#...#.#...#.#.....#.......#.....#.#.#.#...#.#.#.#
#.#.#.###.#.###.#####.#.#######.#####.#.###.#.#.#.#.###.#.#.#
#.#.#.....#.#...#...#.#.....#...#...#...#.#...#.#...#.......#
#.#.#######.#.###.#.#.#####.#.###.#######.#####.#####.#######
#.#.#.....#...#...#...#.....#.#.#.....#.............#.#.....#
#.#.###.###.###.#######.#####.#.#.#.###.###.###.#####.#.###.#
#.#...#.#.....#.#.....#.#.#...#...#.#...#...#.#.#...#.#.#.#.#
#.#.#.#.#.#####.#.#.###.#.#.#####.#.#.###.###.#.#.#.#.#.#.#.#
#.#.#.#...#.....#.#.....#.#.....#.#...#.#.#.....#.#...#.#...#
#.###.#####.#######.#####.#####.###.###.#.#######.#####.#####
#.#...#.....#.....#.....#.....#...#.#...#.........#.....#...#
#.#.###.#####.###.#####.#####.###.#.###.#############.#.###.#
#.#.........#.#...#...#.........#.#.#.....#.#...#.....#.#...#
#.#########.#.#.###.#.#########.#.#.#.###.#.#.###.#####.#.#.#
#.#...#...#...#.#...#.....T...#.#.#.#...#.#.....#.#.....#.#.#
#.###.#.#.#####.#.#########.###.#.#.#.#.###.###.#.#.#####.#.#
#.....#.#.#...#.#.....#...#.....#.#.#.#.....#.....#.#.....#.#
#####.#.#.###.#.#######.#.#.#####.#.#.#.#####.###.#.###.###.#
#...#.#.#...#.#.........#.#...#...#.#.#...#...#...#.....#...#
#.###.#.###.#.###########.###.#.###.#######.###.#############
#.....#.#.........#.....#...#.#.#.#...#.....#.#.#.......#...#
#.#####.###########.#######.###.#.###.#.#####.#.#.#####.#.#.#
#...#.#.#...#.....#.......#...#.#.....#...#...#.#.#.#...#.#.#
###.#.#.#.#.#.###.#.#####.###.#.#.#######.#.###.#.#.#.#####.#
#.....#...#.....#.......#.......#.........#.......#.........#
#############################################################
