#####################################################################################################
#...........#.......#.......#.....#.............#.....#.......................#.........#...#...#...#
###########.#.#####.#.###.###.#.###.#######.#.#.#.#####.#################.###.#.###.###.###.#.#.#.###
#.........#.#...#...#...#.....#...#...#.....#.#...#...#.....#...........#.#.#.#...#...#.......#.#...#
#.#######.#.#####.#.###.#########.###.#.###########.#.#.#####.#########.#.#.#.#######.#########.#.#.#
#...#.#...#.....#.#.#.#.#...#...#.....#.#...........#...#...#...#.....#...#.#.......#.#.......#.#.#.#
###.#.#.#######.###.#.#.###.#.#.#######.#.###############.#.#.#.#.#.#######.#######.#.#.#####.#.#.#.#
#.#...#.#...#...#...#.......#.#.#.....#.......#.......#...#...#...#.#.....#.#.........#.#...#.#.#.#.#
#.#.#.#.#.#.#.###.###.#######.#.###.#######.###.###.###.#####.#######.###.#.#.#.#########.#.#.#.#.#.#
#...#.#...#.#...#.#...#.......#.#...#.....#...#.#.....#.#.....#.......#.#.#...#.#.....#...#...#.#.#.#
#.###.#####.###.#.#.#.#.#######.#.###.#.#####.#.#####.#.#######.#######.#.#####.#.###.#.#######.#.#.#
#...#.....#...#.#.#.#.#...#.#...#.#...#.....#.#...#...#.......#.#...#...#.....#.#.#...#.......#.#.#.#
#########.###.#.#.#.#.###.#.#.###.#.#####.###.###.###########.#.###.#.#.#.###.###.#.#########.#.###.#
#.......#.#.#...#.#.#.#.#.#.#...#...#...#.#...#.#...........#.#.......#.#.#...#...#.#.....#.....#...#
#.#####.#.#.#####.#.#.#.#.#.###.#####.#.#.#.#.#.#######.#.###.#########.#.#.###.#.#.#.###.#.#####.###
#.#.....#.#...#.#...#...#.#...#.#.....#.#...#.....#.....#.#...#.......#.#.#.....#.#.#...#.#.#.....#.#
###.###.#.#.#.#.###.#.###.###.#.#.#####.#########.#.#######.###.###.###.#.#######.#.#####.#.#.#####.#
#...#...#...#.....#.#.#...#...#...#...#.#.....#.......#...#.#...#.#.....#...#...#.#...#...#.#.......#
#.###.###########.#.###.###.#######.#.#.#.###.#########.#.#.#.###.###########.#.#.#.#.#.###.#.#.###.#
#...#.#.....#.....#.#...#.......#...#.#.#...#.......#...#.#.........#.......#.#.#.#.#.#...#.#.#...#.#
###.#.#.#####.#####.#.###.#####.#.###.#.###.#######.#.###.###########.#####.#.#.###.#.###.#.#####.#.#
#...#...#....T#.#...#.#...#...#.#.#.#...#...#.......#...#.....#.......#...#.#.#...#.#...#.#.#.....#.#
#.#.#####.#####.#.###.#.###.#.###.#.#####.#######.#####.###.###.#########.#.#.###.#.###.#.#.#.#####.#
#.#.....#.....#.....#.#.....#...#.#.......#.#...#.....#.#.#...#...#.#.....#...#...#.#.#.#.#...#.....#
#.#####.#####.#####.#.#########.#.#####.#.#.#.#.#####.#.#.###.###.#.#.###.#####.###.#.#.#.#########.#
#...#.#...#.#...#...#.#.........#...#...#.#...#.....#...#...#.....#.#.#...#...#.#.....#.#.....#.....#
###.#.#.#.#.###.#.###.#.#######.###.#.#####.#.#####.#######.#####.#.#.#####.#.#.#######.#####.#.#####
#.....#.#.....#.#...#.#.#.....#.#.#.#.....#.#.....#...#...........#.#.......#.........#.#.....#.....#
#######.#####.#.#####.#.#####.#.#.#.#.###.#.#######.#.###.#########.#.###############.#.#.#.#######.#
#.....#.....#.#.......#.....#.#.#.#.#...#...#.....#.#...#...#.....#...#.............#...#.#.....#...#
#.###.#####.###############.#.#.#.#.###.#####.###.#####.###.#.###.#########.#################.#.#.###
#...#.....#.#.....#.........#.#...#.#.#...###.#...#.....#...#...#.....#.....#.#.....#.........#.#.#.#
###.#####.#.#.###.#.#.#.#####.#.###.#.###.###.#.###.###########.#####.#.###.#.#.###.#.#########.#.#.#
#...#.....#...#...#.#.#.#.......#...#...#...#.#...#.............#.....#.#...#.#.#.#.#...#.......#...#
#.#######.#####.###.###.###########.#.#.###.#.###.#.#.###########.#####.#.###.#.#.#.#.#.###########.#
#.#.........#...#...#...#...#.#...#.#.#.....#.#...#.#.........#...#.....#...#.#.#.#.#.#.#.....#.....#
#.#.#######.#.###.###.###.#.#.#.#.#.#.#######.#.###############.###.#.#####.#.#.#.#.###.#.###.#####.#
#.#.......#...#...#.#.....#.....#...#.....#...#.#...............#...#.....#.#...#.#.....#...#...#...#
#.#####.#########.#.#####################.#.###.###.###############.#####.#.###.#.#####.###.###.#.#.#
#.#...#.#.....#...#.....#.....#.........#.#.#.#.#...#...#...#.....#.....#.#.#...#...#...#.#.#...#.#.#
#.#.#.###.#.###.###.###.###.###.#######.###.#.#.#.#####.#.#.#.###.#####.#.###.###.#.#.###.#.#.#.#.###
#...#.....#.....#.....#...#...#.......#.....#.#...#...#...#.....#...#...#...#...#.#.#.....#.#.#.#...#
#.###.###########.###.###.###.#.#####.#####.#.#.###.#.#############.#.#####.###.#.#.###.###.#.#####.#
#...#...#.....#.#.#...#.#.....#.....#...#.#.#...#...#.#.............#...#.#...#...#.#.#.#...#.#...#.#
#######.#.###.#.#.#.###.#.#############.#.#.#####.#.#.#.#########.#.###.#.#.#######.#.#.#.###.#.#.#.#
#.....#.#.#...#...#.#...#.#.............#.#.#.#...#.#...#.........#...#...#.....#.....#.#.#.#.#.#...#
#.###.#.#.#.#######.#.#.#.#.#####.#######.#.#.#.###.#####################.###.###.#####.#.#.#.#.#####
#.#...#...#.......#.#.#.#.#...#...#.#.....#.#.#.#...#.#S..#.....#...#.....#.#.....#...#...#.#.#...#.#
#.#.#############.#.#.###.#####.###.#.###.#.#.#.#.###.#.#.#.#.#.#.#.#.#####.#######.#.#####.#.###.#.#
#.#.................#...........#.......#...#...#.......#...#.#...#.................#.......#.......#
#####################################################################################################
