#########
#......S#
#.#.#####
#...#...#
#.#####.#
#.......#
#.#####.#
#.#T....#
#########