###########
#....T#.#.#
#.#.###.#.#
#.#.#.....#
#.#.#.###.#
#.#.#.#.#.#
#.#.#.#S#.#
#.#.#.#.#.#
#.#.###.#.#
#.........#
###########