#########################################
#.....#.......#.......#.........#.....#.#
#####.#####.###.#.###.#.#.#######.#.#.#.#
#...#.#.......#.#...#.#.#.....#...#.#.#.#
#.#.#.#.#####.###.#.###.#####.#.###.#.#.#
#.#.....#.......#.#.......#.#...#...#.#.#
#.#############.#.#######.#.#####.###.#.#
#.#.....#.......#.#...#.........#.#...#.#
#.#.###.#.#########.#.#.#########.#.###.#
#.#.#...#.#.........#.#...#...#...#.....#
#.#.#.###.#.#.#######.###.#.#.#.#######.#
#.#.#.....#.#.#.#...#.#.#.#.#...#.......#
###.#########.#.#.###.#.#.#.#####.#######
#...#.........#.....#.#.#.#.#...#.#.....#
#S###########.#####.#.#.#.#.#.#.#.#.###.#
#.#...........#...#...#.#.#.#.#.#.#.#...#
#.###.#########.###.###.#.#.###.#.#.#.###
#...#...#.....#...#...#T..#...#.#...#...#
###.###.#.###.#.#.###.#######.#.#######.#
#.......#...#...#.............#.........#
#########################################