#####
#T#.#
#.#.#
#.S.#
#####
