#####################################################################################################
#.#.......#.......#.#.......#.......#.......#...#.S...#...#...#.....#.........#...........#.....#...#
#.#.#####.#.#####.#.#.###.###.###.#.#.#####.#.#.#####.#.#.#.#.#.###.#.#######.#####.#####.#.#####.#.#
#.#...#.#...#.....#.#...#.#.....#.#.#...#.....#.....#...#.#.#...#.....#.....#.#.........#...#.....#.#
#.###.#.#####.#####.###.#.#.#####.###.#.###########.#####.#.#.###.#####.###.#.#.#########.###.###.#.#
#.#...#.#...#.#.......#.#.#.#...#.....#...#...#...#.....#...#...#.....#...#...#.....#...#...#.#.#.#.#
#.#.###.#.#.#.#####.#.#.###.#.#.###.#####.###.#.#.#####.#################.###.#####.#.#.###.#.#.#.###
#.#.#.#...#...#.....#.#.....#.#...#.#...#.#...#.#.......#...#.............#.#.....#...#.#...#...#...#
#.#.#.#.#######.#####.#######.###.###.#.#.#.###.#########.#.###.###########.###.#.#####.#.#########.#
#...#...........#.............#.......#..T#...............#.....#...............#.......#...........#
#####################################################################################################
